朱立伦即将率团访陆见习近平 行前会见传媒 	博讯网
朱立伦在上海会见俞正声 	博讯网
朱立伦:在九二共识基础上推动两岸关系和平发展 	博讯网
国民党否认将推两岸和平协议政治谈判 	博讯网
朱立伦回北大叙旧 被赞“高大帅” 	博讯网
国民党主席朱立伦应该拜会陈开频 	博讯网
向宪诤：评国共两党“怪胎组合”现象 	博讯网
 习近平会见朱立伦	美国之音
 朱立伦抵达上海展开访问	美国之音
 海峡论谈：朱立伦进京 习朱会能否防两岸地动山摇	美国之音
 美学者评习朱会：习近平寸步不让	美国之音
 中国立法草案：外国NGO可设分支但须经批准	美国之音
 中国劳工活动人士日益成为暴力袭击目标	美国之音
 海峡论谈：“习朱会”是不是朱立伦的政治自杀?	美国之音
 伊春当局：不去三自教会者即为“邪教”	美国之音
习近平与朱立伦会谈 敦促加强两岸经济联系-华尔街日报	华尔街日报
       《中国重要政经日程》--5月4日| Reuters	路透社网
朱立伦访北大忆执教往事 赞赏北大校方民主/图_大陆_新闻_星岛环球网	星岛环球网
习近平：欢迎台湾加入亚投行_大陆_新闻_星岛环球网	星岛环球网
“习朱会”今登场 巩固“九二共识”_台湾_新闻_星岛环球网	星岛环球网
北大欢迎「朱老师」回北大 - 快讯-文汇网	香港文汇报
俞正声会见朱立伦 都是浙江同乡 - 快讯-文汇网	香港文汇报
朱立伦赴上海 自己拉行李通关 - 快讯-文汇网	香港文汇报
习近平会见国民党主席朱立伦 - 纽约时报中文网 国际纵览	纽约时报中文网
习近平将会见台湾国民党主席朱立伦 - 纽约时报中文网 国际纵览	纽约时报中文网
习近平将会见台湾国民党主席朱立伦 - 纽约时报中文网 国际纵览	纽约时报中文网
中国斥百亿投资巴基斯坦水电站 - 纽约时报中文网 国际纵览	纽约时报中文网
6.7级余震袭击尼泊尔地震灾区 - 纽约时报中文网 国际纵览	纽约时报中文网
“习朱会”是不是朱立伦的政治自杀？（视频）	《参与》
向宪诤：台湾是什么？国民党和共产党又是什么？DD评国共两党“怪胎组合”现象	《参与》
国民党主席朱立伦大陆行 浙江民主党人遭严控	《参与》
朱立伦进京 习朱会能否防两岸地动山摇（视频）	《参与》
朱立伦抵京将与习会晤蔡英文：不能被国共、权贵及黑箱化	《参与》
习朱北京会 “两岸同属一中”引争议（视频）	《参与》
朱立伦启程出访大陆 李登辉狠批九二共识	《参与》
郭宝胜：蔡英文访美的挑战与资本	《参与》
揭秘：朱立伦说了什么，让习近平频频点头？ - 大陆资讯 - 倍可亲	倍可亲网
朱立伦启程赴上海 自己拉皮箱没礼遇通关(图) - 台湾热点 - 倍可亲	倍可亲网
朱立伦忆北大往事: 去琉璃厂买表同学帮杀价 - 大陆资讯 - 倍可亲	倍可亲网
朱立伦即将率团访陆见习近平 行前会见传媒 	博讯网
朱立伦在上海会见俞正声 	博讯网
国民党否认将推两岸和平协议政治谈判 	博讯网
朱立伦回北大叙旧 被赞“高大帅” 	博讯网
国民党主席朱立伦应该拜会陈开频 	博讯网
向宪诤：评国共两党“怪胎组合”现象 	博讯网
朱立伦启程赴大陆未走贵宾通道 自己拉行李通关(图)_大公资讯_大公网	大公网
“习朱会”登场 习近平福建厅外亲自迎接朱立伦_大公资讯_大公网	大公网
朱立伦即将率团访陆 行前会见传媒	自由亚洲电台
北京人民大会堂“习朱会”  两岸关系处新“重要节点”	自由亚洲电台
朱立伦在上海会见俞正声 	自由亚洲电台
国民党主席朱立伦大陆行 浙江民主党人遭严控	自由亚洲电台
习近平就台湾加入“亚投行”、“一带一路”作出正面回应	自由亚洲电台
朱立伦深夜返台 受到绿营抗议和批评	自由亚洲电台
朱立伦赴上海访问 台联党到机场抗议	自由亚洲电台
朱立伦赴陆申报 竟未提朱习会 | 新唐人电视台 视频节目 新闻视频 环球直击 环球直击新闻 	新唐人电视台
不选2016 朱立伦：应思考台湾需要的总统 | 新唐人电视台 视频节目 新闻视频 环球直击 环球直击新闻 	新唐人电视台
朱立伦赴陆申报 竟未提朱习会 | 新唐人电视台 视频节目 新闻视频 环球直击 环球直击新闻 	新唐人电视台
台商向朱立伦喊国共合作 竟是中共统战部 | 新唐人电视台 视频节目 新闻视频 环球直击 环球直击新闻 	新唐人电视台
不能实质谈判 台移民署准朱立伦赴陆 | 新唐人电视台 视频节目 新闻视频 环球直击 环球直击新闻 	新唐人电视台
不选2016 朱立伦：应思考台湾需要的总统 | 新唐人电视台 视频节目 新闻视频 环球直击 环球直击新闻 	新唐人电视台
台商向朱立伦喊国共合作 竟是中共统战部 | 新唐人电视台 视频节目 新闻视频 环球直击 环球直击新闻 	新唐人电视台
不能实质谈判 台移民署准朱立伦赴陆 | 新唐人电视台 视频节目 新闻视频 环球直击 环球直击新闻 	新唐人电视台
习近平与朱立伦于北京会面 台媒批指责朱立伦不敢坚持中华民国 - 阿波罗新闻网	阿波罗新闻网
朱立伦提“求同尊异”，习近平提“聚同化异”，两岸症结在于“异”？ - 阿波罗新闻网	阿波罗新闻网
直辖市长朱立伦晤习 被质疑违法 - 阿波罗新闻网	阿波罗新闻网
直辖市长朱立伦晤习 被质疑违法 - 阿波罗新闻网	阿波罗新闻网
朱立伦自拉行李箱 引发大陆网友热议 图 - 阿波罗新闻网	阿波罗新闻网
中国评论新闻：赵春山语中评：朱立伦希扩大九二共识应用面	中评社
中国评论新闻：江丙坤语中评：朱立伦成果丰硕 需政治协商	中评社
中国评论新闻：朱立伦启程赴上海　自己拉皮箱没礼遇通关	中评社
中国评论新闻：张立杰语中评：朱立伦晤习近平有助蓝整合	中评社
中国评论新闻：社评：习朱会承先启后　朱立伦须清晰阐一中	中评社
中国评论新闻：王金平：朱立伦表现当然很好　一定很好	中评社
中国评论新闻：中评镜头：朱立伦谒孙中山　女讲解神似赵薇	中评社
朱习会登场 习近平：两岸关系处于重要节点_两岸-多维新闻网	多维新闻网
连战破冰之旅：国民党的自救行动_历史-多维新闻网	多维新闻网
习朱会承先启后 朱立伦须清晰阐一中_观点-多维新闻网	多维新闻网
朱习会登场 习近平：两岸关系处于重要节点_两岸-多维新闻网	多维新闻网
连战破冰之旅：国民党的自救行动_历史-多维新闻网	多维新闻网
日媒：大陆轻视台湾 两岸关系仍不可测_国际-多维新闻网	多维新闻网
 朱立伦提入亚投行 习近平正面欢迎 | 重点新闻 | 中央社即时新闻 CNA NEWS	台湾中央社
 5月5日台湾各报头条速报 | 重点新闻 | 中央社即时新闻 CNA NEWS	台湾中央社
 朱习会 朱立伦盼台湾参与更多国际活动 | 重点新闻 | 中央社即时新闻 CNA NEWS	台湾中央社
 百年国民党 新掌门朱立伦访陆展新风 | 两岸透视 | 中央社即时新闻 CNA NEWS	台湾中央社
 朱习会4日登场 九二共识扮要角 | 重点新闻 | 中央社即时新闻 CNA NEWS	台湾中央社
 朱习会过招 两人攻防各持立场 | 重点新闻 | 中央社即时新闻 CNA NEWS	台湾中央社
国共党魁会晤　台方标榜九二共识不同定义 朱立伦要求予台湾国际空间 | 苹果日报 | 两岸国际 | 20150505	香港苹果日报
 【朱习会】习近平人民大会堂见朱立伦 | 即时新闻 | 两岸 | 20150504	香港苹果日报
朱立伦今晤习 或提超「九二共识」新表述 | 苹果日报 | 两岸国际 | 20150504	香港苹果日报
 朱立伦今会习近平 拜完孙中山返台 | 即时新闻 | 两岸 | 20150504	香港苹果日报
 台联寸爆行动剧 嘲朱立伦抱习近平大腿 | 即时新闻 | 两岸 | 20150504	香港苹果日报
 【朱习会】习近平：两岸处于重要节点上 | 即时新闻 | 两岸 | 20150504	香港苹果日报
 朱立伦重访北大谈往事 「韩国豆腐锅没了」 | 即时新闻 | 两岸 | 20150504	香港苹果日报
